ObjectId,Date,Daily_Cases,Cumulative_Cases,Recoveries,Total_Recoveries,Deaths,Total_Deaths,New_ICU_Admissions,Current_ICU___Total,Current_ICU___Active,Cumulative_ICU_Admissions,New_IP_Admissions_Total,Current_Hospitalizations___Tota,Current_Hospitalizations___Acti,Cumulative_IP_Admissions,Non_ICU_Hospitalizations___Acti,Active_Cases__not_hospitalized_,Positivity_Rate,Daily_Tests,Cumulative_Tests
1,2020/03/10 05:00:00+00,0,0,0,0,0,0,0,0,0,0,0,0,0,1,0,0,0,99,341
2,2020/03/11 05:00:00+00,0,0,0,0,0,0,0,0,0,0,0,0,0,1,0,0,0,195,536
3,2020/03/12 05:00:00+00,0,0,0,0,0,0,0,0,0,0,0,0,0,1,0,0,0.3,295,831
4,2020/03/13 05:00:00+00,2,2,0,0,0,0,0,0,0,0,1,0,0,2,0,2,0.3,405,1236
5,2020/03/14 05:00:00+00,1,3,0,0,0,0,0,0,0,0,0,0,0,2,0,3,0.3,333,1569
6,2020/03/15 05:00:00+00,0,3,0,0,0,0,0,0,0,0,0,0,0,2,0,3,0.3,264,1833
7,2020/03/16 05:00:00+00,3,6,0,0,0,0,0,0,0,0,0,0,0,2,0,6,0.3,404,2237
8,2020/03/17 05:00:00+00,1,7,0,0,0,0,0,0,0,0,0,0,0,2,0,7,0.7,539,2776
9,2020/03/18 05:00:00+00,7,14,0,0,0,0,0,0,0,0,0,0,0,2,0,14,0.9,448,3224
10,2020/03/19 05:00:00+00,1,15,0,0,0,0,0,0,0,0,1,1,1,3,1,14,1.1,262,3486
11,2020/03/20 05:00:00+00,1,16,0,0,0,0,0,0,0,0,1,1,1,4,1,15,1.1,177,3663
12,2020/03/21 05:00:00+00,0,16,0,0,0,0,0,0,0,0,0,1,1,4,1,15,1.3,267,3930
13,2020/03/22 05:00:00+00,1,17,0,0,0,0,0,0,0,0,1,1,1,5,1,16,0.9,261,4191
14,2020/03/23 05:00:00+00,3,20,1,1,0,0,0,0,0,0,1,0,0,6,0,19,1.1,277,4468
15,2020/03/24 05:00:00+00,1,21,0,1,0,0,0,0,0,0,0,0,0,6,0,20,0.7,350,4818
16,2020/03/25 05:00:00+00,6,27,2,3,0,0,1,1,1,1,0,1,1,6,0,23,1.6,723,5541
17,2020/03/26 05:00:00+00,9,36,1,4,1,1,0,0,0,1,1,0,0,7,0,31,2.5,613,6154
18,2020/03/27 05:00:00+00,27,63,2,6,0,1,1,1,1,2,1,2,2,8,1,54,2.5,905,7059
19,2020/03/28 05:00:00+00,10,73,3,9,0,1,0,1,1,2,1,2,2,9,1,61,2.6,207,7266
20,2020/03/29 05:00:00+00,23,96,1,10,0,1,0,1,1,2,0,4,4,9,3,81,2.4,1194,8460
21,2020/03/30 05:00:00+00,9,105,3,13,0,1,0,1,1,2,1,3,3,10,2,88,2.6,375,8835
22,2020/03/31 05:00:00+00,27,132,4,17,0,1,2,3,3,4,1,4,4,11,1,110,1.9,1095,9930
23,2020/04/01 05:00:00+00,33,165,4,21,0,1,1,4,4,5,2,6,6,13,2,137,2.4,1269,11199
24,2020/04/02 05:00:00+00,16,181,4,25,1,2,2,5,5,7,1,9,9,14,4,145,2.4,623,11822
25,2020/04/03 05:00:00+00,10,191,12,37,0,2,1,6,6,8,2,10,10,16,4,142,2.7,619,12441
26,2020/04/04 05:00:00+00,11,202,1,38,0,2,0,6,6,8,1,10,10,17,4,152,2.3,479,12920
27,2020/04/05 05:00:00+00,1,203,4,42,0,2,1,7,7,9,1,10,10,18,3,149,2.5,457,13377
28,2020/04/06 05:00:00+00,13,216,31,73,1,3,1,6,6,10,0,11,11,18,5,129,1.9,781,14158
29,2020/04/07 05:00:00+00,3,219,25,98,0,3,0,6,6,10,1,11,11,19,5,107,1.4,559,14717
30,2020/04/08 05:00:00+00,2,221,18,116,0,3,0,5,5,10,2,11,11,21,6,91,1.1,548,15265
31,2020/04/09 05:00:00+00,6,227,13,129,1,4,0,5,5,10,0,10,10,21,5,84,1,1067,16332
32,2020/04/10 05:00:00+00,12,239,11,140,0,4,1,5,5,11,0,8,8,21,3,87,1.2,171,16503
33,2020/04/11 05:00:00+00,0,239,3,143,0,4,0,4,4,11,0,8,8,21,4,84,0.7,821,17324
34,2020/04/12 05:00:00+00,2,241,6,149,0,4,0,4,4,11,0,8,8,21,4,80,0.8,32,17356
35,2020/04/13 05:00:00+00,0,241,7,156,0,4,0,4,4,11,1,9,9,22,5,72,0.8,355,17711
36,2020/04/14 05:00:00+00,3,244,16,172,1,5,0,4,4,11,0,9,9,22,5,58,0.9,316,18027
37,2020/04/15 05:00:00+00,4,248,10,182,0,5,0,4,4,11,1,8,8,23,4,53,0.5,462,18489
38,2020/04/16 05:00:00+00,1,249,11,193,0,5,0,4,4,11,1,8,8,24,4,43,0.8,501,18990
39,2020/04/17 05:00:00+00,5,254,11,204,0,5,0,4,4,11,0,7,7,24,3,38,0.7,336,19326
40,2020/04/18 05:00:00+00,2,256,1,205,0,5,1,5,5,12,0,8,8,24,3,38,0.6,591,19917
41,2020/04/19 05:00:00+00,1,257,0,205,0,5,0,5,5,12,0,8,8,24,3,39,0.4,254,20171
42,2020/04/20 05:00:00+00,1,258,7,212,1,6,0,4,4,12,1,7,7,25,3,33,0.4,302,20473
43,2020/04/21 05:00:00+00,0,258,9,221,0,6,0,4,4,12,0,7,7,25,3,24,0.5,434,20907
44,2020/04/22 05:00:00+00,3,261,7,228,0,6,0,3,3,12,1,7,7,26,4,20,0.4,324,21231
45,2020/04/23 05:00:00+00,2,263,1,229,0,6,0,3,3,12,0,6,6,26,3,22,0.6,779,22010
46,2020/04/24 05:00:00+00,3,266,6,235,0,6,0,2,2,12,0,6,6,26,4,19,0.7,595,22605
47,2020/04/25 05:00:00+00,4,270,1,236,0,6,1,2,2,13,0,7,7,26,5,21,0.7,406,23011
48,2020/04/26 05:00:00+00,1,271,0,236,0,6,0,2,2,13,1,7,7,27,5,22,0.4,372,23383
49,2020/04/27 05:00:00+00,2,273,1,237,0,6,0,2,2,13,0,6,6,27,4,24,0.5,315,23698
50,2020/04/28 05:00:00+00,0,273,6,243,0,6,0,0,0,13,0,6,6,27,6,18,0.5,345,24043
51,2020/04/29 05:00:00+00,1,274,2,245,0,6,0,0,0,13,0,5,5,27,5,18,0.4,512,24555
52,2020/04/30 05:00:00+00,4,278,2,247,0,6,0,0,0,13,0,5,5,27,5,20,0.5,673,25228
53,2020/05/01 05:00:00+00,1,279,2,249,0,6,0,0,0,13,0,6,6,27,6,18,0.4,679,25907
54,2020/05/02 05:00:00+00,1,280,0,249,0,6,0,0,0,13,0,5,5,27,5,20,0.4,711,26618
55,2020/05/03 05:00:00+00,0,280,1,250,0,6,0,0,0,13,1,5,5,28,5,19,0.3,627,27245
56,2020/05/04 05:00:00+00,1,281,3,253,1,7,0,0,0,13,0,4,4,28,4,17,0.3,332,27577
57,2020/05/05 05:00:00+00,2,283,1,254,0,7,0,0,0,13,1,5,5,29,5,17,0.2,513,28090
58,2020/05/06 05:00:00+00,0,283,4,258,0,7,0,0,0,13,0,5,5,29,5,13,0.3,523,28613
59,2020/05/07 05:00:00+00,1,284,1,259,0,7,0,0,0,13,1,5,5,30,5,13,0.2,439,29052
60,2020/05/08 05:00:00+00,1,285,2,261,0,7,0,0,0,13,0,4,4,30,4,13,0.2,669,29721
61,2020/05/09 05:00:00+00,2,287,1,262,0,7,0,0,0,13,1,4,4,31,4,14,0.2,698,30419
62,2020/05/10 05:00:00+00,2,289,0,262,0,7,1,1,1,14,0,4,4,31,3,16,0.3,310,30729
63,2020/05/11 05:00:00+00,0,289,2,264,0,7,0,1,1,14,0,4,4,31,3,14,0.2,505,31234
64,2020/05/12 05:00:00+00,0,289,1,265,0,7,0,1,1,14,0,4,4,31,3,13,0.2,521,31755
65,2020/05/13 05:00:00+00,0,289,2,267,0,7,0,1,1,14,0,4,4,31,3,11,0.2,297,32052
66,2020/05/14 05:00:00+00,0,289,1,268,0,7,0,1,1,14,0,3,3,31,2,11,0.1,747,32799
67,2020/05/15 05:00:00+00,0,289,3,271,0,7,0,1,1,14,0,3,2,31,1,9,0,976,33775
68,2020/05/16 05:00:00+00,0,289,0,271,0,7,0,1,1,14,1,3,2,32,1,9,0,764,34539
69,2020/05/17 05:00:00+00,1,290,2,273,0,7,0,0,0,14,0,2,1,32,1,9,0.1,485,35024
70,2020/05/18 05:00:00+00,0,290,0,273,0,7,0,0,0,14,0,2,1,32,1,9,0.1,376,35400
71,2020/05/19 05:00:00+00,0,290,1,274,0,7,0,0,0,14,1,2,1,33,1,8,0.1,245,35645
72,2020/05/20 05:00:00+00,0,290,5,279,0,7,0,0,0,14,0,2,1,33,1,3,0.1,572,36217
73,2020/05/21 05:00:00+00,2,292,0,279,0,7,0,0,0,14,0,2,1,33,1,5,0.1,817,37034
74,2020/05/22 05:00:00+00,0,292,1,280,0,7,0,0,0,14,0,1,0,33,0,5,0.1,577,37611
75,2020/05/23 05:00:00+00,0,292,0,280,0,7,0,0,0,14,0,1,0,33,0,5,0.1,771,38382
76,2020/05/24 05:00:00+00,0,292,0,280,0,7,0,0,0,14,0,1,0,33,0,5,0.1,408,38790
77,2020/05/25 05:00:00+00,0,292,1,281,0,7,0,0,0,14,0,1,0,33,0,4,0.1,355,39145
78,2020/05/26 05:00:00+00,2,294,0,281,0,7,0,0,0,14,0,1,0,33,0,6,0.1,990,40135
79,2020/05/27 05:00:00+00,0,294,0,281,0,7,0,0,0,14,0,1,0,33,0,6,0.1,679,40814
80,2020/05/28 05:00:00+00,0,294,0,281,0,7,0,0,0,14,0,1,0,33,0,6,0.1,1315,42129
81,2020/05/29 05:00:00+00,0,294,0,281,0,7,0,0,0,14,0,1,0,33,0,6,0.1,702,42831
82,2020/05/30 05:00:00+00,1,295,0,281,0,7,0,0,0,14,0,1,0,33,0,7,0.1,779,43610
83,2020/05/31 05:00:00+00,0,295,0,281,0,7,0,0,0,14,0,1,0,33,0,7,0,808,44418
84,2020/06/01 05:00:00+00,3,298,0,281,0,7,0,0,0,14,0,1,0,33,0,10,0.1,378,44796
85,2020/06/02 05:00:00+00,0,298,2,283,0,7,0,0,0,14,0,1,0,33,0,8,0.1,827,45623
86,2020/06/03 05:00:00+00,2,300,0,283,0,7,0,0,0,14,0,1,0,33,0,10,0.2,870,46493
87,2020/06/04 05:00:00+00,0,300,0,283,0,7,0,0,0,14,1,1,0,34,0,10,0.2,624,47117
88,2020/06/05 05:00:00+00,0,300,0,283,0,7,0,0,0,14,0,1,0,34,0,10,0.2,621,47738
89,2020/06/06 05:00:00+00,0,300,0,283,0,7,0,0,0,14,1,0,0,35,0,10,0.1,1144,48882
90,2020/06/07 05:00:00+00,0,300,0,283,0,7,0,0,0,14,0,0,0,35,0,10,0.1,474,49356
91,2020/06/08 05:00:00+00,0,300,3,286,0,7,0,0,0,14,0,0,0,35,0,7,0,489,49845
92,2020/06/09 05:00:00+00,0,300,0,286,0,7,0,0,0,14,0,0,0,35,0,7,0,621,50466
93,2020/06/10 05:00:00+00,0,300,0,286,0,7,0,0,0,14,1,0,0,36,0,7,0,623,51089
94,2020/06/11 05:00:00+00,1,301,1,287,0,7,0,0,0,14,0,0,0,36,0,7,0.1,837,51926
95,2020/06/12 05:00:00+00,2,303,0,287,0,7,0,0,0,14,0,0,0,36,0,9,0.1,699,52625
96,2020/06/13 05:00:00+00,1,304,3,290,0,7,0,0,0,14,0,0,0,36,0,7,0.1,710,53335
97,2020/06/14 05:00:00+00,0,304,0,290,0,7,0,0,0,14,0,0,0,36,0,7,0.1,816,54151
98,2020/06/15 05:00:00+00,0,304,1,291,0,7,0,0,0,14,1,0,0,37,0,6,0.1,146,54297
99,2020/06/16 05:00:00+00,2,306,0,291,0,7,0,0,0,14,0,0,0,37,0,8,0.1,394,54691
100,2020/06/17 05:00:00+00,2,308,0,291,0,7,0,0,0,14,0,0,0,37,0,10,0.2,784,55475
101,2020/06/18 05:00:00+00,1,309,0,291,0,7,0,0,0,14,0,0,0,37,0,11,0.3,616,56091
102,2020/06/19 05:00:00+00,4,313,0,291,0,7,0,0,0,14,0,0,0,37,0,15,0.3,684,56775
103,2020/06/20 05:00:00+00,0,313,0,291,0,7,0,0,0,14,0,0,0,37,0,15,0.3,844,57619
104,2020/06/21 05:00:00+00,1,314,0,291,0,7,0,0,0,14,0,0,0,37,0,16,0.2,367,57986
105,2020/06/22 05:00:00+00,1,315,1,292,0,7,0,0,0,14,1,0,0,38,0,16,0.2,428,58414
106,2020/06/23 05:00:00+00,0,315,1,293,0,7,0,0,0,14,3,0,0,41,0,15,0.1,605,59019
107,2020/06/24 05:00:00+00,1,316,3,296,0,7,0,0,0,14,1,0,0,42,0,13,0,494,59513
108,2020/06/25 05:00:00+00,2,318,2,298,0,7,0,0,0,14,1,0,0,43,0,13,0.1,766,60279
109,2020/06/26 05:00:00+00,4,322,0,298,0,7,0,0,0,14,0,0,0,43,0,17,0.2,1071,61350
110,2020/06/27 05:00:00+00,0,322,3,301,0,7,0,0,0,14,0,0,0,43,0,14,0.2,950,62300
111,2020/06/28 05:00:00+00,2,324,0,301,0,7,0,0,0,14,0,0,0,43,0,16,0.3,466,62766
112,2020/06/29 05:00:00+00,1,325,1,302,0,7,0,0,0,14,0,0,0,43,0,16,0.3,240,63006
113,2020/06/30 05:00:00+00,0,325,2,304,0,7,0,0,0,14,0,0,0,43,0,14,0.2,524,63530
114,2020/07/01 05:00:00+00,0,325,0,304,0,7,0,0,0,14,0,0,0,43,0,14,0.1,412,63942
115,2020/07/02 05:00:00+00,0,325,1,305,0,7,0,0,0,14,0,0,0,43,0,13,0,822,64764
116,2020/07/03 05:00:00+00,0,325,2,307,0,7,0,0,0,14,1,0,0,44,0,11,0,287,65051
117,2020/07/04 05:00:00+00,0,325,2,309,0,7,0,0,0,14,1,0,0,45,0,9,0,681,65732
118,2020/07/05 05:00:00+00,0,325,0,309,0,7,0,0,0,14,0,0,0,45,0,9,0,651,66383
119,2020/07/06 05:00:00+00,0,325,0,309,0,7,0,0,0,14,0,0,0,45,0,9,0,289,66672
120,2020/07/07 05:00:00+00,0,325,2,311,0,7,0,0,0,14,0,0,0,45,0,7,0,555,67227
121,2020/07/08 05:00:00+00,0,325,1,312,0,7,0,0,0,14,0,0,0,45,0,6,0,579,67806
122,2020/07/09 05:00:00+00,0,325,2,314,0,7,0,0,0,14,0,0,0,45,0,4,0,1055,68861
123,2020/07/10 05:00:00+00,0,325,1,315,0,7,0,0,0,14,0,0,0,45,0,3,0,809,69670
124,2020/07/11 05:00:00+00,0,325,0,315,0,7,0,0,0,14,0,0,0,45,0,3,0,1042,70712
125,2020/07/12 05:00:00+00,0,325,1,316,0,7,0,0,0,14,1,0,0,46,0,2,0.1,528,71240
126,2020/07/13 05:00:00+00,5,330,2,318,0,7,0,0,0,14,1,0,0,47,0,5,0.1,369,71609
127,2020/07/14 05:00:00+00,0,330,0,318,0,7,0,0,0,14,0,0,0,47,0,5,0.2,559,72168
128,2020/07/15 05:00:00+00,1,331,1,319,0,7,0,0,0,14,0,0,0,47,0,5,0.2,772,72940
129,2020/07/16 05:00:00+00,5,336,0,319,0,7,0,0,0,14,0,0,0,47,0,10,0.4,896,73836
130,2020/07/17 05:00:00+00,1,337,0,319,0,7,0,0,0,14,1,0,0,48,0,11,0.2,771,74607
131,2020/07/18 05:00:00+00,5,342,0,319,0,7,1,1,1,15,0,1,1,48,0,15,0.3,1144,75751
132,2020/07/19 05:00:00+00,13,355,1,320,0,7,0,1,1,15,1,1,1,49,0,27,0.6,687,76438
133,2020/07/20 05:00:00+00,12,367,2,322,0,7,0,1,1,15,1,1,1,50,0,37,0.8,1007,77445
134,2020/07/21 05:00:00+00,7,374,1,323,0,7,0,1,1,15,1,1,1,51,0,43,0.8,889,78334
135,2020/07/22 05:00:00+00,6,380,0,323,0,7,1,2,2,16,1,2,2,52,0,48,0.9,1026,79360
136,2020/07/23 05:00:00+00,5,385,0,323,0,7,0,2,2,16,0,2,2,52,0,53,0.8,1915,81275
137,2020/07/24 05:00:00+00,6,391,2,325,0,7,0,2,2,16,0,2,2,52,0,57,0.5,1291,82566
138,2020/07/25 05:00:00+00,5,396,2,327,1,8,0,2,2,16,0,2,2,52,0,59,0.4,1621,84187
139,2020/07/26 05:00:00+00,5,401,4,331,0,8,0,2,2,16,1,3,3,53,1,59,0.4,885,85072
140,2020/07/27 05:00:00+00,3,404,8,339,0,8,0,2,2,16,0,3,3,53,1,54,0.4,805,85877
141,2020/07/28 05:00:00+00,3,407,6,345,0,8,0,2,2,16,6,6,6,59,4,48,0.4,620,86497
142,2020/07/29 05:00:00+00,3,410,7,352,0,8,2,4,4,18,0,6,6,59,2,44,0.4,1322,87819
143,2020/07/30 05:00:00+00,6,416,14,366,0,8,0,4,4,18,2,7,7,61,3,35,0.4,1335,89154
144,2020/07/31 05:00:00+00,6,422,8,374,0,8,1,4,4,19,0,7,7,61,3,33,0.3,2284,91438
145,2020/08/01 05:00:00+00,14,436,3,377,0,8,1,4,4,20,2,8,8,63,4,43,0.4,1346,92784
146,2020/08/02 05:00:00+00,5,441,2,379,0,8,1,5,5,21,1,9,9,64,4,45,0.4,1288,94072
147,2020/08/03 05:00:00+00,2,443,5,384,0,8,0,4,4,21,1,9,9,65,5,42,0.5,855,94927
148,2020/08/04 05:00:00+00,3,446,5,389,0,8,0,4,4,21,4,9,9,69,5,40,0.5,1716,96643
149,2020/08/05 05:00:00+00,29,475,4,393,0,8,2,6,6,23,2,11,11,71,5,63,0.9,1104,97747
150,2020/08/06 05:00:00+00,17,492,5,398,0,8,0,4,4,23,1,10,10,72,6,76,1.1,1403,99150
151,2020/08/07 05:00:00+00,16,508,3,401,0,8,0,4,4,23,0,11,11,72,7,88,1.2,2129,101279
152,2020/08/08 05:00:00+00,35,543,5,406,0,8,0,4,4,23,0,8,8,72,4,121,1.4,1479,102758
153,2020/08/09 05:00:00+00,17,560,1,407,0,8,0,3,3,23,2,8,8,74,5,137,1.5,1437,104195
154,2020/08/10 05:00:00+00,3,563,3,410,0,8,1,4,4,24,0,7,7,74,3,138,1.2,768,104963
155,2020/08/11 05:00:00+00,15,578,11,421,0,8,0,4,4,24,1,6,6,75,2,143,1,1802,106765
156,2020/08/12 05:00:00+00,25,603,7,428,0,8,0,3,3,24,2,8,8,77,5,159,1.2,1733,108498
157,2020/08/13 05:00:00+00,38,641,9,437,0,8,1,4,4,25,3,10,10,80,6,186,1.2,2261,110759
158,2020/08/14 05:00:00+00,19,660,17,454,1,9,0,3,3,25,1,9,9,81,6,188,1.4,1920,112679
159,2020/08/15 05:00:00+00,36,696,40,494,1,10,0,3,3,25,1,9,9,82,6,183,1.4,1887,114566
160,2020/08/16 05:00:00+00,40,736,15,509,1,11,0,3,3,25,2,10,10,84,7,206,1.7,1601,116167
161,2020/08/17 05:00:00+00,13,749,19,528,1,12,0,2,2,25,3,9,8,87,6,201,1.7,1110,117277
162,2020/08/18 05:00:00+00,15,764,31,559,0,12,0,2,2,25,0,8,7,87,5,186,1.6,1280,118557
163,2020/08/19 05:00:00+00,33,797,16,575,0,12,0,1,1,25,1,8,7,88,6,203,1.8,1675,120232
164,2020/08/20 05:00:00+00,35,832,19,594,0,12,0,1,0,25,3,6,4,91,4,222,1.9,1941,122173
165,2020/08/21 05:00:00+00,42,874,27,621,0,12,0,1,0,25,2,7,5,93,5,236,1.7,1994,124167
166,2020/08/22 05:00:00+00,98,972,13,634,0,12,0,0,0,25,0,8,6,93,6,320,2.6,1670,125837
167,2020/08/23 05:00:00+00,28,1000,20,654,1,13,1,1,1,26,0,8,5,93,4,328,2.7,1537,127374
168,2020/08/24 05:00:00+00,28,1028,14,668,0,13,0,1,1,26,3,9,6,96,5,341,2.6,1065,128439
169,2020/08/25 05:00:00+00,26,1054,32,700,0,13,0,1,1,26,2,10,7,98,6,334,3,1181,129620
170,2020/08/26 05:00:00+00,33,1087,32,732,1,14,0,1,1,26,3,8,5,101,4,336,3,1413,131033
171,2020/08/27 05:00:00+00,27,1114,40,772,0,14,0,1,1,26,1,8,5,102,4,323,2.3,1245,132278
172,2020/08/28 05:00:00+00,47,1161,47,819,0,14,0,1,1,26,4,11,8,106,7,320,2.5,1697,133975
173,2020/08/29 05:00:00+00,36,1197,34,853,0,14,0,1,1,26,0,12,9,106,8,321,2.2,1961,135936
174,2020/08/30 05:00:00+00,25,1222,49,902,0,14,0,1,1,26,1,12,8,107,7,298,1.9,1694,137630
175,2020/08/31 05:00:00+00,18,1240,45,947,0,14,0,1,1,26,0,15,11,107,10,268,2.1,552,138182
176,2020/09/01 05:00:00+00,7,1247,42,989,1,15,0,1,1,26,1,14,10,108,9,233,1.7,1573,139755
177,2020/09/02 05:00:00+00,20,1267,31,1020,1,16,0,1,1,26,1,13,9,109,8,222,1.3,1359,141114
178,2020/09/03 05:00:00+00,9,1276,31,1051,0,16,0,1,1,26,5,13,8,114,7,201,1.3,1744,142858
179,2020/09/04 05:00:00+00,33,1309,32,1083,0,16,1,2,2,27,1,16,11,115,9,199,1.4,1869,144727
180,2020/09/05 05:00:00+00,16,1325,28,1111,0,16,0,2,2,27,1,15,10,116,8,188,1.1,1696,146423
181,2020/09/06 05:00:00+00,16,1341,26,1137,0,16,0,2,2,27,0,15,10,116,8,178,1.2,1076,147499
182,2020/09/07 05:00:00+00,10,1351,22,1159,0,16,1,3,3,28,4,15,10,120,7,166,1.4,1290,148789
183,2020/09/08 05:00:00+00,16,1367,23,1182,0,16,0,3,3,28,1,13,9,121,6,160,1.3,660,149449
184,2020/09/09 05:00:00+00,14,1381,17,1199,0,16,0,3,3,28,0,13,9,121,6,157,1.3,1174,150623
185,2020/09/10 05:00:00+00,15,1396,16,1215,0,16,0,3,3,28,3,15,11,124,8,154,1.4,1490,152113
186,2020/09/11 05:00:00+00,17,1413,11,1226,0,16,0,3,3,28,3,16,12,127,9,159,1.4,1608,153721
187,2020/09/12 05:00:00+00,20,1433,18,1244,0,16,0,2,2,28,1,19,14,128,12,159,1.3,1531,155252
188,2020/09/13 05:00:00+00,19,1452,16,1260,0,16,0,2,2,28,1,16,11,129,9,165,1.4,1047,156299
189,2020/09/14 05:00:00+00,17,1469,22,1282,0,16,0,2,2,28,3,16,11,132,9,160,1.4,1470,157769
190,2020/09/15 05:00:00+00,23,1492,20,1302,0,16,0,2,2,28,2,13,7,134,5,167,1.5,1287,159056
191,2020/09/16 05:00:00+00,11,1503,8,1310,0,16,0,1,1,28,3,14,8,137,7,169,1.7,1414,160470
192,2020/09/17 05:00:00+00,40,1543,24,1334,0,16,0,1,1,28,2,15,8,139,7,185,1.7,1399,161869
193,2020/09/18 05:00:00+00,17,1560,21,1355,0,16,1,2,1,29,1,15,7,140,6,182,1.6,1678,163547
194,2020/09/19 05:00:00+00,29,1589,22,1377,0,16,0,2,1,29,3,15,7,143,6,189,1.9,1465,165012
195,2020/09/20 05:00:00+00,22,1611,12,1389,2,18,0,2,1,29,1,13,5,144,4,199,1.9,1480,166492
196,2020/09/21 05:00:00+00,24,1635,15,1404,1,19,0,2,1,29,5,12,5,149,4,207,2,1210,167702
197,2020/09/22 05:00:00+00,42,1677,15,1419,0,19,2,4,3,31,5,14,8,154,5,231,2.1,1693,169395
198,2020/09/23 05:00:00+00,40,1717,22,1441,0,19,1,5,4,32,2,13,7,156,3,250,2.6,1745,171140
199,2020/09/24 05:00:00+00,58,1775,23,1464,0,19,1,6,5,33,2,17,11,158,6,281,2.5,2562,173702
200,2020/09/25 05:00:00+00,66,1841,27,1491,0,19,0,5,5,33,4,17,11,162,6,320,2.4,2615,176317
201,2020/09/26 05:00:00+00,42,1883,21,1512,1,20,1,6,6,34,3,18,12,165,6,339,2.3,2378,178695
202,2020/09/27 05:00:00+00,44,1927,16,1528,0,20,0,6,6,34,2,18,12,167,6,367,2.2,1576,180271
203,2020/09/28 05:00:00+00,35,1962,18,1546,0,20,1,7,7,35,3,20,14,170,7,382,2.2,1396,181667
204,2020/09/29 05:00:00+00,38,2000,14,1560,1,21,2,8,8,37,4,19,13,174,5,406,2,2450,184117
205,2020/09/30 05:00:00+00,33,2033,28,1588,0,21,0,8,8,37,9,21,15,183,7,409,2.1,1780,185897
206,2020/10/01 05:00:00+00,40,2073,20,1608,1,22,1,8,8,38,4,24,18,187,10,425,2.2,1443,187340
207,2020/10/02 05:00:00+00,45,2118,19,1627,0,22,0,8,7,38,7,27,20,194,13,449,2.3,2313,189653
208,2020/10/03 05:00:00+00,44,2162,9,1636,1,23,0,8,7,38,8,28,21,202,14,482,2.2,2096,191749
209,2020/10/04 05:00:00+00,28,2190,19,1655,1,24,1,8,7,39,3,30,23,205,16,488,2.3,1235,192984
210,2020/10/05 05:00:00+00,56,2246,28,1683,0,24,0,8,7,39,10,34,27,215,20,512,2.5,1917,194901
211,2020/10/06 05:00:00+00,45,2291,16,1699,3,27,0,6,5,39,12,31,24,227,19,541,2.6,2370,197271
212,2020/10/07 05:00:00+00,58,2349,25,1724,1,28,1,7,6,40,9,32,25,236,19,572,2.9,2739,200010
213,2020/10/08 05:00:00+00,97,2446,31,1755,3,31,1,7,6,41,5,32,25,241,19,635,3,3001,203011
214,2020/10/09 05:00:00+00,86,2532,24,1779,1,32,1,7,6,42,9,31,24,250,18,697,3.2,2371,205382
215,2020/10/10 05:00:00+00,130,2662,29,1808,1,33,0,7,6,42,8,31,24,258,18,797,3.1,3310,208692
216,2020/10/11 05:00:00+00,90,2752,23,1831,1,34,0,7,6,42,5,34,26,263,20,861,3.3,2051,210743
217,2020/10/12 05:00:00+00,67,2819,27,1858,2,36,0,7,5,42,6,35,26,269,21,899,3.5,2205,212948
218,2020/10/13 05:00:00+00,127,2946,52,1910,2,38,1,5,2,43,8,31,20,277,18,978,4.4,2084,215032
219,2020/10/14 05:00:00+00,160,3106,40,1950,0,38,0,5,2,43,15,30,21,292,19,1097,4.9,2119,217151
220,2020/10/15 05:00:00+00,76,3182,44,1994,0,38,2,6,3,45,7,30,21,299,18,1129,5.3,2171,219322
221,2020/10/16 05:00:00+00,106,3288,37,2031,1,39,1,6,3,46,12,35,24,311,21,1194,5,2750,222072
222,2020/10/17 05:00:00+00,35,3323,31,2062,3,42,1,7,4,47,7,33,22,318,18,1197,4.7,2490,224562
223,2020/10/18 05:00:00+00,68,3391,18,2080,1,43,1,7,4,48,5,32,21,323,17,1247,4.2,1727,226289
224,2020/10/19 05:00:00+00,136,3527,49,2129,0,43,0,7,4,48,9,39,27,332,23,1328,4.2,2223,228512
225,2020/10/20 05:00:00+00,168,3695,59,2188,4,47,1,8,5,49,5,42,28,337,23,1432,4.8,2210,230722
226,2020/10/21 05:00:00+00,160,3855,67,2255,3,50,1,9,5,50,15,51,39,352,34,1511,5.7,2258,232980
227,2020/10/22 05:00:00+00,178,4033,93,2348,1,51,0,8,4,50,12,62,50,364,46,1584,6.5,2653,235633
228,2020/10/23 05:00:00+00,164,4197,89,2437,2,53,1,9,5,51,15,81,68,379,63,1639,6.7,2208,237841
229,2020/10/24 05:00:00+00,164,4361,45,2482,2,55,5,14,10,56,6,88,76,385,66,1748,6.8,2255,240096
230,2020/10/25 05:00:00+00,126,4487,58,2540,3,58,4,17,12,60,11,92,80,396,68,1809,6.9,2225,242321
231,2020/10/26 05:00:00+00,200,4687,70,2610,1,59,0,15,11,60,15,94,83,411,72,1935,7.3,1740,244061
232,2020/10/27 05:00:00+00,174,4861,85,2695,5,64,1,15,11,61,18,98,87,429,76,2015,7.3,3427,247488
233,2020/10/28 05:00:00+00,289,5150,149,2844,2,66,7,22,18,68,8,108,97,437,79,2143,8.5,3514,251002
234,2020/10/29 05:00:00+00,373,5523,115,2959,1,67,1,22,17,69,13,116,102,450,85,2395,8.6,3131,254133
235,2020/10/30 05:00:00+00,231,5754,93,3052,7,74,2,21,16,71,13,123,110,463,94,2518,8.8,2622,256755
236,2020/10/31 05:00:00+00,402,6156,85,3137,8,82,3,22,17,74,17,136,123,480,106,2814,8.8,4048,260803
237,2020/11/01 05:00:00+00,141,6297,46,3183,2,84,0,21,16,74,11,143,130,491,114,2900,8.9,2741,263544
238,2020/11/02 06:00:00+00,197,6494,68,3251,9,93,3,22,17,77,16,150,135,507,118,3015,8.6,2590,266134
239,2020/11/03 06:00:00+00,285,6779,91,3342,4,97,3,24,18,80,20,162,142,527,124,3198,8.7,3503,269637
240,2020/11/04 06:00:00+00,449,7228,111,3453,5,102,3,25,18,83,20,174,153,547,135,3520,8.8,4151,273788
241,2020/11/05 06:00:00+00,227,7455,145,3598,8,110,1,24,17,84,20,181,160,567,143,3587,8.8,3500,277288
242,2020/11/06 06:00:00+00,314,7769,98,3696,8,118,5,27,21,89,26,182,163,593,142,3792,9.2,4427,281715
243,2020/11/07 06:00:00+00,450,8219,87,3783,4,122,4,30,24,93,24,195,174,617,150,4140,9.1,3745,285460
244,2020/11/08 06:00:00+00,343,8562,97,3880,8,130,4,32,27,97,14,208,188,631,161,4364,9.4,3431,288891
245,2020/11/09 06:00:00+00,344,8906,153,4033,6,136,5,35,31,102,27,222,198,658,167,4539,10.3,2188,291079
246,2020/11/10 06:00:00+00,508,9414,147,4180,11,147,3,35,31,105,29,232,206,687,175,4881,10.6,5424,296503
247,2020/11/11 06:00:00+00,434,9848,139,4319,9,156,4,38,34,109,25,242,211,712,177,5162,11,3768,300271
248,2020/11/12 06:00:00+00,409,10257,173,4492,7,163,4,40,36,113,25,249,217,737,181,5385,11.8,3855,304126
249,2020/11/13 06:00:00+00,369,10626,194,4686,7,170,2,40,35,115,30,243,212,767,177,5558,12.3,2991,307117
250,2020/11/14 06:00:00+00,443,11069,191,4877,6,176,6,45,39,121,26,255,226,793,187,5790,12.4,2771,309888
251,2020/11/15 06:00:00+00,350,11419,139,5016,9,185,10,51,45,131,28,277,244,821,199,5974,12.9,2418,312306
252,2020/11/16 06:00:00+00,306,11725,166,5182,10,195,4,52,46,135,29,285,249,850,203,6099,13.5,3146,315452
253,2020/11/17 06:00:00+00,417,12142,157,5339,8,203,2,50,44,137,21,298,259,871,215,6341,13.9,3166,318618
254,2020/11/18 06:00:00+00,442,12584,221,5560,10,213,3,49,43,140,20,304,261,891,218,6550,13.9,3357,321975
255,2020/11/19 06:00:00+00,431,13015,250,5810,8,221,2,46,40,142,28,324,276,919,236,6708,13.5,3172,325147
256,2020/11/20 06:00:00+00,352,13367,241,6051,13,234,3,48,41,145,26,323,270,945,229,6812,13.5,3248,328395
257,2020/11/21 06:00:00+00,247,13614,151,6202,12,246,3,48,41,148,29,328,279,974,238,6887,13.5,3026,331421
258,2020/11/22 06:00:00+00,593,14207,243,6445,6,252,9,55,47,157,18,340,289,992,242,7221,13.6,3089,334510
259,2020/11/23 06:00:00+00,432,14639,281,6726,15,267,4,55,48,161,38,352,292,1030,244,7354,13.8,3568,338078
260,2020/11/24 06:00:00+00,340,14979,230,6956,15,282,4,53,46,165,35,360,301,1065,255,7440,13.7,2916,340994
261,2020/11/25 06:00:00+00,381,15360,242,7198,9,291,9,52,45,174,29,367,309,1094,264,7562,14.1,2180,343174
262,2020/11/26 06:00:00+00,320,15680,234,7432,12,303,4,49,41,178,30,375,318,1124,277,7627,14,3483,346657
263,2020/11/27 06:00:00+00,492,16172,329,7761,12,315,5,50,43,183,23,389,332,1147,289,7764,13.9,2955,349612
264,2020/11/28 06:00:00+00,341,16513,222,7983,11,326,2,46,39,185,23,400,342,1170,303,7862,13.3,3212,352824
265,2020/11/29 06:00:00+00,353,16866,276,8259,11,337,4,47,41,189,19,409,346,1189,305,7924,13.2,2757,355581
266,2020/11/30 06:00:00+00,256,17122,406,8665,18,355,3,46,40,192,17,396,331,1206,291,7771,12.9,2284,357865
267,2020/12/01 06:00:00+00,292,17414,210,8875,16,371,8,50,43,200,27,419,353,1233,310,7815,13.2,2266,360131
268,2020/12/02 06:00:00+00,369,17783,206,9081,11,382,8,54,46,208,17,422,349,1250,303,7971,13.1,2933,363064
269,2020/12/03 06:00:00+00,322,18105,274,9355,14,396,8,58,48,216,33,432,353,1283,305,8001,13.7,3241,366305
270,2020/12/04 06:00:00+00,402,18507,343,9698,13,409,8,62,53,224,25,439,355,1308,302,8045,13.8,3048,369353
271,2020/12/05 06:00:00+00,368,18875,217,9915,17,426,4,59,49,228,24,442,359,1332,310,8175,14,2279,371632
272,2020/12/06 06:00:00+00,272,19147,3694,13609,12,438,4,59,45,232,18,441,313,1350,268,4787,13.9,1896,373528
273,2020/12/07 06:00:00+00,260,19407,335,13944,9,447,3,61,45,235,22,441,316,1372,271,4700,13.6,2357,375885
274,2020/12/08 06:00:00+00,257,19664,302,14246,15,462,3,58,43,238,27,435,311,1399,268,4645,13.4,2348,378233
275,2020/12/09 06:00:00+00,309,19973,264,14510,10,472,4,60,44,242,18,431,313,1417,269,4678,13.3,2563,380796
276,2020/12/10 06:00:00+00,449,20422,356,14866,15,487,5,60,45,247,23,433,301,1440,256,4768,13.7,2730,383526
277,2020/12/11 06:00:00+00,373,20795,277,15143,15,502,3,54,39,250,18,419,293,1458,254,4857,13.7,2817,386343
278,2020/12/12 06:00:00+00,246,21041,220,15363,10,512,3,49,36,253,20,423,299,1478,263,4867,13.7,2162,388505
279,2020/12/13 06:00:00+00,244,21285,235,15598,11,523,6,51,37,259,24,428,303,1502,266,4861,13.6,2140,390645
280,2020/12/14 06:00:00+00,260,21545,356,15954,15,538,2,52,39,261,14,423,302,1516,263,4751,14.2,1561,392206
281,2020/12/15 06:00:00+00,285,21830,253,16207,14,552,4,51,38,265,22,428,309,1538,271,4762,13.5,2442,394648
282,2020/12/16 06:00:00+00,224,22054,241,16448,17,569,4,48,37,269,13,413,298,1551,261,4739,13,2260,396908
283,2020/12/17 06:00:00+00,348,22402,606,17054,11,580,2,48,37,271,17,408,293,1568,256,4475,13.6,2170,399078
284,2020/12/18 06:00:00+00,240,22642,167,17221,4,584,5,53,42,276,17,400,286,1585,244,4551,13.2,2506,401584
285,2020/12/19 06:00:00+00,223,22865,151,17372,10,594,3,51,40,279,17,405,288,1602,248,4611,12.2,2302,403886
286,2020/12/20 06:00:00+00,168,23033,139,17511,6,600,4,53,40,283,16,414,299,1618,259,4623,11.5,1957,405843
287,2020/12/21 06:00:00+00,153,23186,1450,18961,15,615,1,47,36,284,17,410,261,1635,225,3349,11.5,1498,407341
288,2020/12/22 06:00:00+00,202,23388,168,19129,9,624,1,45,33,285,16,393,247,1651,214,3388,10.4,2219,409560
289,2020/12/23 06:00:00+00,241,23629,163,19292,14,638,5,41,32,290,13,379,244,1664,212,3455,10.6,2165,411725
290,2020/12/24 06:00:00+00,176,23805,170,19462,13,651,3,37,28,293,13,372,239,1677,211,3453,10.6,1716,413441
291,2020/12/25 06:00:00+00,198,24003,149,19611,5,656,2,37,29,295,13,376,242,1690,213,3494,11.8,1323,414764
292,2020/12/26 06:00:00+00,146,24149,138,19749,12,668,1,38,29,296,12,380,242,1702,213,3490,12,1239,416003
293,2020/12/27 06:00:00+00,116,24265,138,19887,5,673,3,39,30,299,8,381,236,1710,206,3469,12.6,1080,417083
294,2020/12/28 06:00:00+00,124,24389,149,20036,5,678,3,41,32,302,10,374,231,1720,199,3444,12.5,1372,418455
295,2020/12/29 06:00:00+00,125,24514,87,20123,3,681,0,40,31,302,13,369,235,1733,204,3475,12.6,1193,419648
296,2020/12/30 06:00:00+00,185,24699,118,20241,3,684,1,38,29,303,17,368,233,1750,204,3541,11.2,2106,421754
297,2020/12/31 06:00:00+00,154,24853,116,20357,7,691,4,39,30,307,12,357,223,1762,193,3582,10.7,1486,423240
298,2021/01/01 06:00:00+00,180,25033,160,20517,7,698,4,41,30,311,13,365,228,1775,198,3590,10.3,1978,425218
299,2021/01/02 06:00:00+00,94,25127,174,20691,3,701,4,42,32,315,12,373,232,1787,200,3503,10.3,1079,426297
300,2021/01/03 06:00:00+00,122,25249,109,20800,4,705,2,43,32,317,7,372,229,1794,197,3515,10.6,1284,427581
301,2021/01/04 06:00:00+00,131,25380,95,20895,9,714,1,40,30,318,12,367,225,1806,195,3546,10.6,1265,428846
302,2021/01/05 06:00:00+00,185,25565,89,20984,9,723,3,40,30,321,11,353,211,1817,181,3647,10.3,1868,430714
303,2021/01/06 06:00:00+00,179,25744,104,21088,8,731,0,36,27,321,9,346,209,1826,182,3716,9.9,2133,432847
304,2021/01/07 06:00:00+00,226,25970,142,21230,7,738,0,32,23,321,10,341,204,1836,181,3798,10.1,2390,435237
305,2021/01/08 06:00:00+00,200,26170,121,21351,6,744,5,35,26,326,18,344,213,1854,187,3862,9.9,2182,437419
306,2021/01/09 06:00:00+00,140,26310,101,21452,5,749,4,37,29,330,7,344,212,1861,183,3897,10,1557,438976
307,2021/01/10 06:00:00+00,135,26445,1331,22783,3,752,1,36,20,331,10,347,156,1871,136,2754,10,1569,440545
308,2021/01/11 06:00:00+00,103,26548,229,23012,5,757,5,38,22,336,10,338,139,1881,117,2640,10.1,1369,441914
309,2021/01/12 06:00:00+00,149,26697,283,23295,7,764,1,37,16,337,11,323,122,1892,106,2516,9.6,1778,443692
310,2021/01/13 06:00:00+00,257,26954,244,23539,1,765,3,39,16,340,7,327,125,1899,109,2525,10,2351,446043
311,2021/01/14 06:00:00+00,189,27143,112,23651,3,768,3,38,15,343,9,321,125,1908,110,2599,10,2025,448068
312,2021/01/15 06:00:00+00,179,27322,86,23737,6,774,1,37,16,344,17,317,132,1925,116,2679,10.4,2059,450127
313,2021/01/16 06:00:00+00,183,27505,84,23821,5,779,4,37,19,348,15,325,144,1940,125,2761,10.7,2067,452194
314,2021/01/17 06:00:00+00,121,27626,93,23914,6,785,5,37,21,353,15,325,143,1955,122,2784,10.9,1333,453527
315,2021/01/18 06:00:00+00,113,27739,119,24033,7,792,1,37,20,354,10,315,138,1965,118,2776,10.3,1471,454998
316,2021/01/19 06:00:00+00,161,27900,69,24102,7,799,3,36,20,357,9,306,134,1974,114,2865,9.9,1915,456913
317,2021/01/20 06:00:00+00,216,28116,119,24221,1,800,3,37,21,360,11,303,133,1985,112,2962,9.5,2273,459186
318,2021/01/21 06:00:00+00,183,28299,111,24332,5,805,0,34,20,360,17,304,142,2002,122,3020,9.3,2069,461255
319,2021/01/22 06:00:00+00,212,28511,97,24429,5,810,2,32,18,362,16,301,139,2018,121,3133,9.8,1835,463090
320,2021/01/23 06:00:00+00,224,28735,93,24522,2,812,3,35,20,365,13,305,147,2031,127,3254,10.7,1965,465055
321,2021/01/24 06:00:00+00,131,28866,84,24606,6,818,3,31,17,368,10,305,147,2041,130,3295,10.7,1621,466676
322,2021/01/25 06:00:00+00,64,28930,126,24732,5,823,4,33,20,372,13,297,137,2054,117,3238,10.3,1118,467794
323,2021/01/26 06:00:00+00,88,29018,109,24841,6,829,1,31,19,373,10,288,123,2064,104,3225,9.7,1578,469372
324,2021/01/27 06:00:00+00,133,29151,116,24957,2,831,1,30,18,374,10,283,123,2074,105,3240,8.7,2264,471636
325,2021/01/28 06:00:00+00,167,29318,100,25057,3,834,3,32,21,377,9,279,121,2083,100,3306,7.6,2177,473813
326,2021/01/29 06:00:00+00,161,29479,150,25207,2,836,4,34,23,381,18,277,119,2101,96,3317,7.3,1947,475760
327,2021/01/30 06:00:00+00,104,29583,125,25332,5,841,3,34,23,384,3,268,110,2104,87,3300,7.9,1472,477232
328,2021/01/31 06:00:00+00,89,29672,125,25457,2,843,1,33,22,385,11,266,108,2115,86,3264,7.8,1646,478878
329,2021/02/01 06:00:00+00,100,29772,137,25594,2,845,0,29,17,385,8,267,105,2123,88,3228,7.6,1414,480292
330,2021/02/02 06:00:00+00,113,29885,99,25693,3,848,1,27,15,386,10,270,112,2133,97,3232,7,1840,482132
331,2021/02/03 06:00:00+00,96,29981,127,25820,1,849,2,27,16,388,9,271,116,2142,100,3196,6.7,2184,484316
332,2021/02/04 06:00:00+00,101,30082,90,25910,7,856,1,28,17,389,11,269,118,2153,101,3198,6,2242,486558
333,2021/02/05 06:00:00+00,86,30168,175,26085,4,860,5,32,21,394,14,262,111,2167,90,3112,6.1,1530,488088
334,2021/02/06 06:00:00+00,78,30246,108,26193,2,862,0,29,18,394,10,265,112,2177,94,3079,6.1,1435,489523
335,2021/02/07 06:00:00+00,50,30296,1537,27730,3,865,1,28,15,395,7,276,107,2184,92,1594,5.9,1379,490902
336,2021/02/08 06:00:00+00,73,30369,95,27825,6,871,0,26,13,395,8,271,106,2192,93,1567,5.4,1323,492225
337,2021/02/09 06:00:00+00,52,30421,63,27888,2,873,2,27,14,397,5,260,99,2197,85,1561,5.2,1611,493836
338,2021/02/10 06:00:00+00,86,30507,67,27955,4,877,2,26,13,399,6,250,91,2203,78,1584,4.9,1894,495730
339,2021/02/11 06:00:00+00,83,30590,66,28021,2,879,1,23,12,400,8,248,92,2211,80,1598,4.8,1975,497705
340,2021/02/12 06:00:00+00,97,30687,53,28074,3,882,1,22,13,401,9,238,90,2220,77,1641,5,1561,499266
341,2021/02/13 06:00:00+00,79,30766,88,28162,3,885,2,23,14,403,3,235,86,2223,72,1633,5.2,1585,500851
342,2021/02/14 06:00:00+00,78,30844,76,28238,1,886,1,22,14,404,4,235,89,2227,75,1631,5.8,1289,502140
343,2021/02/15 06:00:00+00,115,30959,86,28324,2,888,1,23,15,405,5,243,92,2232,77,1655,5.9,1405,503545
344,2021/02/16 06:00:00+00,78,31037,139,28463,1,889,2,25,17,407,5,240,90,2237,73,1595,5.9,1145,504690
345,2021/02/17 06:00:00+00,110,31147,456,28919,3,892,2,25,17,409,6,231,86,2243,69,1250,6,1827,506517
346,2021/02/18 06:00:00+00,93,31240,78,28997,2,894,1,25,17,410,5,221,86,2248,69,1263,5.7,2389,508906
347,2021/02/19 06:00:00+00,91,31331,66,29063,1,895,2,26,19,412,3,211,86,2251,67,1287,5.3,1642,510548
348,2021/02/20 06:00:00+00,54,31385,85,29148,1,896,2,26,18,414,6,215,89,2257,71,1252,5.3,2065,512613
349,2021/02/21 06:00:00+00,104,31489,66,29214,2,898,1,27,19,415,7,214,86,2264,67,1291,5.4,1796,514409
350,2021/02/22 06:00:00+00,61,31550,67,29281,1,899,2,28,19,417,5,224,93,2269,74,1277,5,1393,515802
351,2021/02/23 06:00:00+00,39,31589,46,29327,2,901,0,24,16,417,3,216,90,2272,74,1271,4.6,1806,517608
352,2021/02/24 06:00:00+00,66,31655,53,29380,3,904,1,23,16,418,3,208,86,2275,70,1285,4.3,2296,519904
353,2021/02/25 06:00:00+00,69,31724,62,29442,1,905,0,21,14,418,8,201,81,2283,67,1296,3.9,1927,521831
354,2021/02/26 06:00:00+00,79,31803,77,29519,2,907,2,22,16,420,2,200,79,2285,63,1298,3.7,1681,523512
355,2021/02/27 06:00:00+00,52,31855,75,29594,3,910,0,20,14,420,4,199,78,2289,64,1273,3.7,1868,525380
356,2021/02/28 06:00:00+00,38,31893,48,29642,2,912,1,21,15,421,7,197,80,2296,65,1259,4,1250,526630
357,2021/03/01 06:00:00+00,52,31945,56,29698,1,913,2,21,14,423,10,202,82,2306,68,1252,4,1309,527939
358,2021/03/02 06:00:00+00,52,31997,41,29739,1,914,2,22,15,425,6,202,84,2312,69,1260,3.8,1788,529727
359,2021/03/03 06:00:00+00,49,32046,46,29785,1,915,0,21,14,425,8,197,82,2320,68,1264,3.2,2230,531957
360,2021/03/04 06:00:00+00,54,32100,52,29837,1,916,1,22,15,426,4,190,77,2324,62,1270,3,2070,534027
361,2021/03/05 06:00:00+00,66,32166,68,29905,1,917,0,21,14,426,5,177,69,2329,55,1275,3.1,1670,535697
362,2021/03/06 06:00:00+00,59,32225,34,29939,2,919,0,20,13,426,7,180,71,2336,58,1296,3.3,1679,537376
363,2021/03/07 06:00:00+00,65,32290,36,29975,2,921,1,18,12,427,4,186,76,2340,64,1318,3.5,1392,538768
364,2021/03/08 06:00:00+00,67,32357,39,30014,3,924,3,20,14,430,3,183,74,2343,60,1345,3.8,1235,540003
365,2021/03/09 06:00:00+00,75,32432,40,30054,1,925,1,20,13,431,7,182,73,2350,60,1380,3.8,1927,541930
366,2021/03/10 06:00:00+00,87,32519,66,30120,1,926,0,19,12,431,4,177,76,2354,64,1397,3.7,2117,544047
367,2021/03/11 06:00:00+00,101,32620,393,30513,0,926,2,21,12,433,7,177,78,2361,66,1103,4.1,2216,546263
368,2021/03/12 06:00:00+00,88,32708,62,30575,2,928,1,20,12,434,4,170,74,2365,62,1131,4.2,1858,548121
369,2021/03/13 06:00:00+00,39,32747,53,30628,1,929,2,22,14,436,7,171,76,2372,62,1114,4.6,1585,549706
370,2021/03/14 06:00:00+00,60,32807,45,30673,2,931,2,22,13,438,2,170,75,2374,62,1128,4.8,1523,551229
371,2021/03/15 05:00:00+00,121,32928,39,30712,0,931,2,23,14,440,8,170,77,2382,63,1208,5.1,1543,552772
372,2021/03/16 05:00:00+00,93,33021,51,30763,0,931,0,22,13,440,5,171,79,2387,66,1248,4.4,2033,554805
373,2021/03/17 05:00:00+00,70,33091,40,30803,0,931,1,21,13,441,7,166,79,2394,66,1278,4.7,2496,557301
374,2021/03/18 05:00:00+00,95,33186,59,30862,1,932,3,23,14,444,2,163,78,2396,64,1314,4.7,2175,559476
375,2021/03/19 05:00:00+00,85,33271,76,30938,1,933,1,23,14,445,3,161,78,2399,64,1322,5,2003,561479
376,2021/03/20 05:00:00+00,89,33360,59,30997,0,933,2,25,16,447,6,163,80,2405,64,1350,5.1,1733,563212
377,2021/03/21 05:00:00+00,70,33430,48,31045,1,934,1,25,16,448,6,166,82,2411,66,1369,5.3,1547,564759
378,2021/03/22 05:00:00+00,101,33531,45,31090,0,934,2,26,17,450,7,171,84,2418,67,1423,5.5,1584,566343
379,2021/03/23 05:00:00+00,69,33600,59,31149,2,936,0,25,16,450,8,172,85,2426,69,1430,4.8,2497,568840
380,2021/03/24 05:00:00+00,117,33717,233,31382,1,937,2,26,16,452,6,176,84,2432,68,1314,4.3,2768,571608
381,2021/03/25 05:00:00+00,103,33820,57,31439,1,938,3,27,16,455,5,176,84,2437,68,1359,4.3,1980,573588
382,2021/03/26 05:00:00+00,51,33871,39,31478,2,940,2,23,14,457,6,173,85,2443,71,1368,4.2,2061,575649
383,2021/03/27 05:00:00+00,59,33930,82,31560,1,941,2,24,14,459,3,172,83,2446,69,1346,3.8,1932,577581
384,2021/03/28 05:00:00+00,58,33988,57,31617,0,941,0,24,14,459,6,175,83,2452,69,1347,4.2,1696,579277
385,2021/03/29 05:00:00+00,64,34052,56,31673,1,942,2,26,16,461,6,175,83,2458,67,1354,4.3,1166,580443
386,2021/03/30 05:00:00+00,74,34126,49,31722,0,942,2,26,17,463,7,170,84,2465,67,1378,3.8,2262,582705
387,2021/03/31 05:00:00+00,58,34184,52,31774,1,943,0,26,17,463,8,173,88,2473,71,1379,3.9,1591,584296
388,2021/04/01 05:00:00+00,108,34292,78,31852,1,944,1,26,17,464,5,172,92,2478,75,1404,4.4,2389,586685
389,2021/04/02 05:00:00+00,67,34359,50,31902,1,945,2,27,18,466,3,166,89,2481,71,1423,4.4,1476,588161
390,2021/04/03 05:00:00+00,68,34427,49,31951,3,948,0,25,15,466,3,164,85,2484,70,1443,4.6,1475,589636
391,2021/04/04 05:00:00+00,67,34494,60,32011,1,949,3,27,18,469,3,165,84,2487,66,1450,5.1,1363,590999
392,2021/04/05 05:00:00+00,64,34558,84,32095,3,952,0,26,16,469,2,162,81,2489,65,1430,5.2,1537,592536
393,2021/04/06 05:00:00+00,128,34686,66,32161,0,952,2,27,18,471,7,162,83,2496,65,1490,4.8,2308,594844
394,2021/04/07 05:00:00+00,120,34806,337,32498,1,953,2,27,18,473,5,164,81,2501,63,1274,5.2,2303,597147
395,2021/04/08 05:00:00+00,180,34986,83,32581,0,953,1,27,19,474,2,160,80,2503,61,1372,5.5,2816,599963
396,2021/04/09 05:00:00+00,122,35108,91,32672,0,953,1,27,19,475,8,162,82,2511,63,1401,5.7,2218,602181
397,2021/04/10 05:00:00+00,115,35223,80,32752,3,956,0,26,18,475,3,155,75,2514,57,1440,5.9,2168,604349
398,2021/04/11 05:00:00+00,129,35352,73,32825,1,957,1,26,17,476,5,156,74,2519,57,1496,6.2,2037,606386
399,2021/04/12 05:00:00+00,109,35461,70,32895,1,958,1,27,18,477,7,157,77,2526,59,1531,6,1973,608359
400,2021/04/13 05:00:00+00,93,35554,72,32967,0,958,1,28,18,478,6,159,76,2532,58,1553,5.5,2694,611053
401,2021/04/14 05:00:00+00,150,35704,85,33052,2,960,3,30,19,481,5,157,74,2537,55,1618,5.4,2898,613951
402,2021/04/15 05:00:00+00,108,35812,94,33146,1,961,0,29,19,481,10,151,75,2547,56,1630,5,2943,616894
403,2021/04/16 05:00:00+00,178,35990,111,33257,1,962,1,28,18,482,5,149,74,2552,56,1697,5.3,3104,619998
404,2021/04/17 05:00:00+00,169,36159,115,33372,1,963,0,27,17,482,8,153,77,2560,60,1747,5.6,2383,622381
405,2021/04/18 05:00:00+00,109,36268,132,33504,1,964,1,25,16,483,9,153,79,2569,63,1721,5.8,2542,624923
406,2021/04/19 05:00:00+00,203,36471,110,33614,2,966,2,27,18,485,5,150,80,2574,62,1811,6.1,2437,627360
407,2021/04/20 05:00:00+00,162,36633,142,33756,3,969,2,26,18,487,13,154,84,2587,66,1824,6.3,3189,630549
408,2021/04/21 05:00:00+00,262,36895,426,34182,4,973,4,29,20,491,15,163,89,2602,69,1651,6.4,3765,634314
409,2021/04/22 05:00:00+00,177,37072,128,34310,3,976,3,31,22,494,10,163,89,2612,67,1697,6.5,3800,638114
410,2021/04/23 05:00:00+00,275,37347,144,34454,1,977,1,28,20,495,5,163,94,2617,74,1822,6.9,3068,641182
411,2021/04/24 05:00:00+00,265,37612,180,34634,2,979,2,28,20,497,7,165,94,2624,74,1905,7.1,3021,644203
412,2021/04/25 05:00:00+00,208,37820,164,34798,2,981,2,26,18,499,12,171,99,2636,81,1942,7.6,2819,647022
413,2021/04/26 05:00:00+00,207,38027,156,34954,0,981,4,29,20,503,11,168,99,2647,79,1993,7.5,2817,649839
414,2021/04/27 05:00:00+00,204,38231,145,35099,0,981,2,30,22,505,7,167,95,2654,73,2056,7.3,3738,653577
415,2021/04/28 05:00:00+00,220,38451,170,35269,1,982,2,32,24,507,17,170,101,2671,77,2099,7.1,3522,657099
416,2021/04/29 05:00:00+00,291,38742,202,35471,2,984,3,32,23,510,20,178,107,2691,84,2180,7.1,3769,660868
417,2021/04/30 05:00:00+00,285,39027,189,35660,2,986,2,32,24,512,14,181,110,2705,86,2271,7.3,4070,664938
418,2021/05/01 05:00:00+00,275,39302,203,35863,1,987,3,33,24,515,16,194,122,2721,98,2330,7.7,3248,668186
419,2021/05/02 05:00:00+00,240,39542,172,36035,1,988,5,35,26,520,21,206,129,2742,103,2390,8,2960,671146
420,2021/05/03 05:00:00+00,300,39842,190,36225,3,991,8,41,34,528,16,214,138,2758,104,2488,8.5,2897,674043
421,2021/05/04 05:00:00+00,269,40111,203,36428,3,994,3,41,33,531,16,213,141,2774,108,2548,8.7,3048,677091
422,2021/05/05 05:00:00+00,372,40483,426,36854,1,995,8,46,38,539,18,215,140,2792,102,2494,9.1,3999,681090
423,2021/05/06 05:00:00+00,473,40956,303,37157,3,998,4,44,36,543,27,233,158,2819,122,2643,9.6,4813,685903
424,2021/05/07 05:00:00+00,501,41457,325,37482,5,1003,11,50,41,554,17,229,154,2836,113,2818,10.4,4692,690595
425,2021/05/08 05:00:00+00,495,41952,334,37816,1,1004,3,47,37,557,17,238,160,2853,123,2972,10.9,4311,694906
426,2021/05/09 05:00:00+00,522,42474,293,38109,1,1005,4,47,37,561,13,243,164,2866,127,3196,11.6,3843,698749
427,2021/05/10 05:00:00+00,353,42827,291,38400,3,1008,10,52,42,571,26,243,167,2892,125,3252,12,3065,701814
428,2021/05/11 05:00:00+00,338,43165,278,38678,1,1009,3,53,42,574,24,252,176,2916,134,3302,12.1,3668,705482
429,2021/05/12 05:00:00+00,586,43751,503,39181,2,1011,5,55,45,579,27,266,190,2943,145,3369,12,5018,710500
430,2021/05/13 05:00:00+00,457,44208,421,39602,4,1015,6,59,48,585,17,262,184,2960,136,3407,11.8,4006,714506
431,2021/05/14 05:00:00+00,447,44655,385,39987,2,1017,5,61,51,590,31,269,192,2991,141,3459,11.9,3808,718314
432,2021/05/15 05:00:00+00,530,45185,337,40324,3,1020,7,63,54,597,33,284,212,3024,158,3629,12.3,3693,722007
433,2021/05/16 05:00:00+00,421,45606,333,40657,4,1024,8,63,54,605,20,290,213,3044,159,3712,12.7,3227,725234
434,2021/05/17 05:00:00+00,380,45986,390,41047,3,1027,7,60,52,612,32,290,210,3076,158,3702,13,3011,728245
435,2021/05/18 05:00:00+00,383,46369,327,41374,0,1027,3,62,54,615,33,303,223,3109,169,3745,13.4,3450,731695
436,2021/05/19 05:00:00+00,601,46970,533,41907,4,1031,7,61,52,622,30,306,224,3139,172,3808,13.7,3872,735567
437,2021/05/20 05:00:00+00,585,47555,456,42363,4,1035,5,60,48,627,24,309,223,3163,175,3934,14,4006,739573
438,2021/05/21 05:00:00+00,470,48025,405,42768,3,1038,7,55,44,634,42,312,233,3205,189,3986,14.2,3729,743302
439,2021/05/22 05:00:00+00,413,48438,360,43128,1,1039,5,55,43,639,30,330,248,3235,205,4023,14.4,3240,746542
440,2021/05/23 05:00:00+00,368,48806,382,43510,3,1042,5,53,43,644,28,334,253,3263,210,4001,14.3,3012,749554
441,2021/05/24 05:00:00+00,244,49050,334,43844,3,1045,12,58,47,656,21,329,247,3284,200,3914,13.8,2485,752039
442,2021/05/25 05:00:00+00,312,49362,345,44189,3,1048,11,57,47,667,31,336,244,3315,197,3881,13.2,2508,754547
443,2021/05/26 05:00:00+00,310,49672,420,44609,2,1050,10,61,49,677,33,349,249,3348,200,3764,12.5,3453,758000
444,2021/05/27 05:00:00+00,488,50160,402,45011,5,1055,5,58,45,682,24,339,240,3372,195,3854,12.5,3685,761685
445,2021/05/28 05:00:00+00,348,50508,386,45397,3,1058,5,55,43,687,25,335,242,3397,199,3811,12.4,2782,764467
446,2021/05/29 05:00:00+00,276,50784,302,45699,1,1059,10,57,44,697,24,336,245,3421,201,3781,12.3,3007,767474
447,2021/05/30 05:00:00+00,310,51094,342,46041,7,1066,10,59,44,707,23,340,247,3444,203,3740,12.1,2607,770081
448,2021/05/31 05:00:00+00,226,51320,288,46329,6,1072,7,60,46,714,22,335,241,3466,195,3678,11.9,2511,772592
449,2021/06/01 05:00:00+00,276,51596,239,46568,7,1079,8,58,44,722,21,336,246,3487,202,3703,11.4,2927,775519
450,2021/06/02 05:00:00+00,349,51945,450,47018,2,1081,10,62,47,732,22,339,246,3509,199,3600,11.4,3216,778735
451,2021/06/03 05:00:00+00,323,52268,335,47353,4,1085,4,59,42,736,23,335,236,3532,194,3594,11.4,2694,781429
452,2021/06/04 05:00:00+00,266,52534,305,47658,2,1087,6,57,43,742,24,338,243,3556,200,3546,11.6,2487,783916
453,2021/06/05 05:00:00+00,226,52760,256,47914,3,1090,4,60,44,746,16,343,244,3572,200,3512,12,2013,785929
454,2021/06/06 05:00:00+00,177,52937,243,48157,3,1093,2,59,43,748,13,340,236,3585,193,3451,12,1841,787770
455,2021/06/07 05:00:00+00,227,53164,337,48494,4,1097,7,61,47,755,16,336,239,3601,192,3334,12,1994,789764
456,2021/06/08 05:00:00+00,251,53415,285,48779,3,1100,5,63,48,760,16,323,223,3617,175,3313,11.6,2718,792482
457,2021/06/09 05:00:00+00,249,53664,435,49214,5,1105,2,58,42,762,17,312,214,3634,172,3131,11.1,2617,795099
458,2021/06/10 05:00:00+00,230,53894,322,49536,2,1107,3,56,42,765,12,304,205,3646,163,3046,10.7,2346,797445
459,2021/06/11 05:00:00+00,273,54167,313,49849,4,1111,2,48,37,767,25,310,211,3671,174,2996,10.9,2544,799989
460,2021/06/12 05:00:00+00,201,54368,320,50169,3,1114,3,49,40,770,12,296,201,3683,161,2884,10.8,1952,801941
461,2021/06/13 05:00:00+00,125,54493,297,50466,2,1116,4,52,43,774,16,297,201,3699,158,2710,10.7,1680,803621
462,2021/06/14 05:00:00+00,132,54625,206,50672,4,1120,6,52,43,780,22,297,193,3721,150,2640,10.6,1581,805202
463,2021/06/15 05:00:00+00,131,54756,221,50893,4,1124,8,55,45,788,6,281,180,3727,135,2559,9.7,2174,807376
464,2021/06/16 05:00:00+00,172,54928,401,51294,2,1126,4,56,45,792,9,274,169,3736,124,2339,8.8,2080,809456
465,2021/06/17 05:00:00+00,171,55099,262,51556,1,1127,0,52,40,792,6,266,156,3742,116,2260,8.3,2170,811626
466,2021/06/18 05:00:00+00,139,55238,221,51777,3,1130,5,51,39,797,9,255,153,3751,114,2178,8.3,1952,813578
467,2021/06/19 05:00:00+00,92,55330,184,51961,4,1134,3,48,36,800,15,259,156,3766,120,2079,8,1398,814976
468,2021/06/20 05:00:00+00,80,55410,128,52089,3,1137,7,52,38,807,9,254,153,3775,115,2031,8,1585,816561
469,2021/06/21 05:00:00+00,74,55484,224,52313,2,1139,2,48,36,809,5,242,143,3780,107,1889,7.6,1242,817803
470,2021/06/22 05:00:00+00,122,55606,169,52482,1,1140,1,48,36,810,6,232,129,3786,93,1855,7.1,2014,819817
471,2021/06/23 05:00:00+00,99,55705,163,52645,1,1141,3,46,34,813,10,227,121,3796,87,1798,6.4,2207,822024
472,2021/06/24 05:00:00+00,83,55788,137,52782,1,1142,2,45,34,815,3,212,110,3799,76,1754,5.9,1713,823737
473,2021/06/25 05:00:00+00,93,55881,200,52982,0,1142,2,46,35,817,10,207,107,3809,72,1650,6.1,1306,825043
474,2021/06/26 05:00:00+00,96,55977,125,53107,2,1144,0,43,33,817,9,212,112,3818,79,1614,6.6,1631,826674
475,2021/06/27 05:00:00+00,64,56041,72,53179,2,1146,3,44,32,820,8,213,113,3826,81,1603,6.2,1490,828164
476,2021/06/28 05:00:00+00,63,56104,73,53252,3,1149,1,40,27,821,3,200,104,3829,77,1599,6.3,1129,829293
477,2021/06/29 05:00:00+00,73,56177,73,53325,4,1153,3,38,26,824,9,198,105,3838,79,1594,6.3,1663,830956
478,2021/06/30 05:00:00+00,79,56256,373,53698,0,1153,1,36,24,825,9,195,101,3847,77,1304,6,1473,832429
479,2021/07/01 05:00:00+00,51,56307,68,53766,1,1154,3,36,23,828,7,190,97,3854,74,1290,5.4,1304,833733
480,2021/07/02 05:00:00+00,45,56352,86,53852,2,1156,3,36,24,831,2,184,89,3856,65,1255,5.8,984,834717
481,2021/07/03 05:00:00+00,62,56414,53,53905,2,1158,3,37,24,834,3,177,82,3859,58,1269,6,1174,835891
482,2021/07/04 05:00:00+00,68,56482,68,53973,1,1159,0,33,21,834,7,180,86,3866,65,1264,6.3,1129,837020
483,2021/07/05 05:00:00+00,42,56524,75,54048,1,1160,2,32,19,836,9,180,88,3875,69,1228,5.9,998,838018
484,2021/07/06 05:00:00+00,69,56593,45,54093,2,1162,1,30,17,837,5,177,87,3880,70,1251,5.6,1668,839686
485,2021/07/07 05:00:00+00,71,56664,53,54146,0,1162,0,30,16,837,6,171,82,3886,66,1274,5.4,1680,841366
486,2021/07/08 05:00:00+00,72,56736,54,54200,1,1163,3,31,16,840,7,172,78,3893,62,1295,5.1,1597,842963
487,2021/07/09 05:00:00+00,80,56816,66,54266,2,1165,3,32,18,843,9,170,79,3902,61,1306,4.9,1259,844222
488,2021/07/10 05:00:00+00,63,56879,53,54319,0,1165,3,34,20,846,1,164,71,3903,51,1324,5.2,1397,845619
489,2021/07/11 05:00:00+00,32,56911,74,54393,0,1165,1,31,17,847,5,164,72,3908,55,1281,4.9,1336,846955
490,2021/07/12 05:00:00+00,23,56934,37,54430,1,1166,0,30,16,847,9,160,71,3917,55,1267,4.4,1043,847998
491,2021/07/13 05:00:00+00,51,56985,40,54470,0,1166,0,28,16,847,5,158,66,3922,50,1283,3.9,1649,849647
492,2021/07/14 05:00:00+00,40,57025,36,54506,0,1166,1,27,15,848,6,160,68,3928,53,1285,3.4,1644,851291
493,2021/07/15 05:00:00+00,39,57064,47,54553,2,1168,2,27,16,850,4,151,59,3932,43,1284,3,1658,852949
494,2021/07/16 05:00:00+00,62,57126,58,54611,0,1168,0,27,16,850,8,150,59,3940,43,1288,3.2,1423,854372
495,2021/07/17 05:00:00+00,50,57176,72,54683,0,1168,0,25,14,850,7,154,63,3947,49,1262,3.6,1205,855577
496,2021/07/18 05:00:00+00,26,57202,36,54719,1,1169,3,27,14,853,2,152,60,3949,46,1254,3.5,1265,856842
497,2021/07/19 05:00:00+00,30,57232,36,54755,2,1171,1,28,15,854,3,145,56,3952,41,1250,3.6,1054,857896
498,2021/07/20 05:00:00+00,38,57270,35,54790,2,1173,1,28,15,855,2,138,50,3954,35,1257,3.5,1898,859794
499,2021/07/21 05:00:00+00,49,57319,426,55216,0,1173,0,28,14,855,5,137,49,3959,35,881,3.3,1555,861349
500,2021/07/22 05:00:00+00,36,57355,27,55243,1,1174,0,28,14,855,6,137,49,3965,35,889,3,1497,862846
501,2021/07/23 05:00:00+00,62,57417,47,55290,0,1174,0,27,11,855,7,137,49,3972,38,904,3.2,1486,864332
502,2021/07/24 05:00:00+00,27,57444,30,55320,1,1175,1,27,11,856,2,137,50,3974,39,899,3.2,1466,865798
503,2021/07/25 05:00:00+00,15,57459,32,55352,1,1176,0,26,10,856,6,143,56,3980,46,875,3,1241,867039
504,2021/07/26 05:00:00+00,16,57475,42,55394,1,1177,2,26,12,858,2,141,53,3982,41,851,2.7,1117,868156
505,2021/07/27 05:00:00+00,28,57503,33,55427,0,1177,3,29,14,861,2,137,51,3984,37,848,2.5,1648,869804
506,2021/07/28 05:00:00+00,54,57557,29,55456,2,1179,2,29,15,863,3,134,48,3987,33,874,2.2,1794,871598
507,2021/07/29 05:00:00+00,40,57597,30,55486,1,1180,1,27,15,864,2,129,51,3989,36,880,2.3,1613,873211
508,2021/07/30 05:00:00+00,20,57617,21,55507,3,1183,0,22,11,864,4,125,47,3993,36,880,2.3,1278,874489
509,2021/07/31 05:00:00+00,33,57650,33,55540,0,1183,1,22,12,865,7,129,51,4000,39,876,2.6,1394,875883
510,2021/08/01 05:00:00+00,20,57670,31,55571,0,1183,0,20,10,865,2,130,47,4002,37,869,2.8,826,876709
511,2021/08/02 05:00:00+00,21,57691,12,55583,0,1183,0,20,9,865,3,129,47,4005,38,878,2.6,1362,878071
512,2021/08/03 05:00:00+00,13,57704,17,55600,1,1184,0,19,8,865,5,126,45,4010,37,875,2.3,1086,879157
513,2021/08/04 05:00:00+00,34,57738,21,55621,0,1184,0,18,7,865,3,124,44,4013,37,889,2.2,1869,881026
514,2021/08/05 05:00:00+00,25,57763,17,55638,0,1184,0,17,7,865,4,122,45,4017,38,896,1.9,1680,882706
515,2021/08/06 05:00:00+00,29,57792,15,55653,0,1184,1,17,8,866,5,119,46,4022,38,909,1.9,1380,884086
516,2021/08/07 05:00:00+00,46,57838,33,55686,0,1184,1,18,8,867,3,118,43,4025,35,925,2.4,1269,885355
517,2021/08/08 05:00:00+00,24,57862,17,55703,1,1185,1,17,8,868,4,118,42,4029,34,932,2.5,1332,886687
518,2021/08/09 05:00:00+00,24,57886,21,55724,1,1186,0,16,8,868,1,111,37,4030,29,939,2.7,1266,887953
519,2021/08/10 05:00:00+00,36,57922,31,55755,2,1188,1,16,8,869,2,107,35,4032,27,944,2.8,1867,889820
520,2021/08/11 05:00:00+00,29,57951,24,55779,1,1189,0,15,7,869,3,106,34,4035,27,949,2.6,1590,891410
521,2021/08/12 05:00:00+00,22,57973,30,55809,0,1189,0,15,7,869,1,101,30,4036,23,945,1.9,2103,893513
522,2021/08/13 05:00:00+00,23,57996,24,55833,0,1189,0,15,7,869,2,97,27,4038,20,947,1.9,1123,894636
523,2021/08/14 05:00:00+00,29,58025,13,55846,0,1189,0,15,7,869,1,96,28,4039,21,962,1.8,1901,896537
524,2021/08/15 05:00:00+00,30,58055,18,55864,0,1189,0,15,7,869,5,100,33,4044,26,969,1.8,1389,897926
525,2021/08/16 05:00:00+00,16,58071,47,55911,0,1189,1,16,7,870,3,95,30,4047,23,941,1.8,1292,899218
526,2021/08/17 05:00:00+00,37,58108,25,55936,0,1189,1,17,8,871,0,92,29,4047,21,954,2,2309,901527
527,2021/08/18 05:00:00+00,27,58135,298,56234,0,1189,1,18,9,872,3,89,28,4050,19,684,1.9,1969,903496
528,2021/08/19 05:00:00+00,44,58179,46,56280,0,1189,0,17,9,872,4,86,27,4054,18,683,2.1,1814,905310
529,2021/08/20 05:00:00+00,41,58220,25,56305,0,1189,0,17,9,872,3,89,30,4057,21,696,2.1,1679,906989
530,2021/08/21 05:00:00+00,38,58258,34,56339,1,1190,0,16,8,872,3,89,31,4060,23,698,2.2,1702,908691
531,2021/08/22 05:00:00+00,33,58291,30,56369,0,1190,1,16,8,873,4,87,31,4064,23,701,2.3,1122,909813
532,2021/08/23 05:00:00+00,36,58327,29,56398,0,1190,1,17,9,874,4,87,32,4068,23,707,2.5,1678,911491
533,2021/08/24 05:00:00+00,100,58427,59,56457,0,1190,0,17,7,874,4,88,29,4072,22,751,2.9,2298,913789
534,2021/08/25 05:00:00+00,47,58474,37,56494,0,1190,0,17,6,874,1,91,30,4073,24,760,2.8,1993,915782
535,2021/08/26 05:00:00+00,34,58508,36,56530,0,1190,0,17,6,874,5,92,31,4078,25,757,2.9,2259,918041
536,2021/08/27 05:00:00+00,94,58602,51,56581,1,1191,1,18,6,875,1,91,31,4079,25,799,3.1,2199,920240
537,2021/08/28 05:00:00+00,48,58650,44,56625,1,1192,1,18,6,876,3,89,29,4082,23,804,3.2,1715,921955
538,2021/08/29 05:00:00+00,29,58679,26,56651,0,1192,0,18,6,876,3,92,31,4085,25,805,3,1608,923563
539,2021/08/30 05:00:00+00,31,58710,46,56697,1,1193,0,17,5,876,3,89,27,4088,22,793,3,1664,925227
540,2021/08/31 05:00:00+00,50,58760,37,56734,1,1194,1,13,4,877,5,91,29,4093,25,803,2.9,2235,927462
541,2021/09/01 05:00:00+00,39,58799,109,56843,0,1194,0,13,4,877,4,92,32,4097,28,730,2.5,2501,929963
542,2021/09/02 05:00:00+00,50,58849,38,56881,3,1197,0,12,2,877,8,91,31,4105,29,740,2.4,2163,932126
543,2021/09/03 05:00:00+00,41,58890,42,56923,1,1198,1,13,3,878,7,95,36,4112,33,733,2.4,1981,934107
544,2021/09/04 05:00:00+00,43,58933,43,56966,1,1199,1,13,4,879,8,98,39,4120,35,729,2.5,1751,935858
545,2021/09/05 05:00:00+00,32,58965,37,57003,1,1200,2,14,6,881,3,96,39,4123,33,723,2.6,1564,937422
546,2021/09/06 05:00:00+00,33,58998,44,57047,0,1200,1,13,6,882,4,96,40,4127,34,711,2.7,1432,938854
547,2021/09/07 05:00:00+00,54,59052,34,57081,1,1201,0,12,5,882,3,95,38,4130,33,732,2.8,2079,940933
548,2021/09/08 05:00:00+00,55,59107,41,57122,1,1202,4,14,5,886,8,95,38,4138,33,745,2.7,2463,943396
549,2021/09/09 05:00:00+00,98,59205,49,57171,1,1203,2,15,6,888,6,94,39,4144,33,792,3,2646,946042
550,2021/09/10 05:00:00+00,70,59275,53,57224,1,1204,0,13,5,888,7,94,39,4151,34,808,3.2,2280,948322
551,2021/09/11 05:00:00+00,59,59334,49,57273,0,1204,1,13,6,889,2,90,36,4153,30,821,3.3,1936,950258
552,2021/09/12 05:00:00+00,38,59372,41,57314,1,1205,1,13,6,890,4,87,34,4157,28,819,3.3,1812,952070
553,2021/09/13 05:00:00+00,50,59422,41,57355,0,1205,1,13,6,891,2,86,35,4159,29,827,3.3,2180,954250
554,2021/09/14 05:00:00+00,47,59469,49,57404,0,1205,1,14,7,892,7,88,35,4166,28,825,2.9,2538,956788
555,2021/09/15 05:00:00+00,69,59538,44,57448,0,1205,1,13,7,893,1,82,34,4167,27,851,2.6,2979,959767
556,2021/09/16 05:00:00+00,76,59614,67,57515,1,1206,0,12,6,893,10,90,41,4177,35,852,2.6,2912,962679
557,2021/09/17 05:00:00+00,46,59660,58,57573,0,1206,2,14,8,895,3,86,38,4180,30,843,2.4,2859,965538
558,2021/09/18 05:00:00+00,61,59721,62,57635,2,1208,0,12,6,895,5,83,36,4185,30,842,2.5,2628,968166
559,2021/09/19 05:00:00+00,40,59761,51,57686,0,1208,1,13,7,896,6,87,40,4191,33,827,2.4,2472,970638
560,2021/09/20 05:00:00+00,60,59821,54,57740,0,1208,3,16,9,899,8,93,44,4199,35,829,2.4,2362,973000
561,2021/09/21 05:00:00+00,54,59875,64,57804,0,1208,0,16,9,899,6,93,44,4205,35,819,2.3,3059,976059
562,2021/09/22 05:00:00+00,71,59946,154,57958,0,1208,3,15,10,902,6,89,44,4211,34,736,2.3,3378,979437
563,2021/09/23 05:00:00+00,61,60007,56,58014,1,1209,2,16,11,904,10,92,46,4221,35,738,2.1,3777,983214
564,2021/09/24 05:00:00+00,94,60101,59,58073,0,1209,2,16,11,906,9,95,49,4230,38,770,2.3,3908,987122
565,2021/09/25 05:00:00+00,126,60227,73,58146,2,1211,2,16,11,908,8,94,48,4238,37,822,2.6,3551,990673
566,2021/09/26 05:00:00+00,71,60298,51,58197,1,1212,4,20,15,912,12,98,53,4250,38,836,2.7,2485,993158
567,2021/09/27 05:00:00+00,40,60338,64,58261,0,1212,2,20,15,914,12,104,54,4262,39,811,2.8,2428,995586
568,2021/09/28 05:00:00+00,113,60451,75,58336,0,1212,1,20,15,915,12,108,56,4274,41,847,3.1,3338,998924
569,2021/09/29 05:00:00+00,105,60556,54,58390,1,1213,2,20,15,917,9,103,56,4283,41,897,3.2,3558,1002482
570,2021/09/30 05:00:00+00,82,60638,79,58469,1,1214,2,19,15,919,11,107,63,4294,48,892,3.2,3670,1006152
571,2021/10/01 05:00:00+00,103,60741,91,58560,1,1215,1,18,14,920,9,108,62,4303,48,904,3.3,2896,1009048
572,2021/10/02 05:00:00+00,127,60868,79,58639,0,1215,1,17,13,921,5,108,61,4308,48,953,3.4,3033,1012081
573,2021/10/03 05:00:00+00,109,60977,69,58708,1,1216,1,18,14,922,7,112,64,4315,50,989,3.7,2426,1014507
574,2021/10/04 05:00:00+00,73,61050,64,58772,1,1217,1,18,14,923,3,107,62,4318,48,999,3.8,2461,1016968
575,2021/10/05 05:00:00+00,84,61134,84,58856,1,1218,1,18,13,924,5,106,62,4323,49,998,3.6,3183,1020151
576,2021/10/06 05:00:00+00,131,61265,129,58985,1,1219,0,16,11,924,5,102,55,4328,44,1006,3.3,4313,1024464
577,2021/10/07 05:00:00+00,131,61396,77,59062,2,1221,2,15,10,926,9,110,59,4337,49,1054,3.4,3607,1028071
578,2021/10/08 05:00:00+00,89,61485,77,59139,2,1223,2,16,11,928,7,103,58,4344,47,1065,3.2,3385,1031456
579,2021/10/09 05:00:00+00,106,61591,74,59213,2,1225,2,17,12,930,8,103,59,4352,47,1094,3.4,2321,1033777
580,2021/10/10 05:00:00+00,76,61667,80,59293,1,1226,1,17,12,931,9,108,62,4361,50,1086,3.6,1934,1035711
581,2021/10/11 05:00:00+00,60,61727,58,59351,0,1226,1,17,12,932,6,108,62,4367,50,1088,3.9,1936,1037647
582,2021/10/12 05:00:00+00,112,61839,81,59432,1,1227,2,19,14,934,10,115,65,4377,51,1115,3.7,2154,1039801
583,2021/10/13 05:00:00+00,60,61899,59,59491,2,1229,0,16,11,934,11,112,65,4388,54,1114,3.7,3385,1043186
584,2021/10/14 05:00:00+00,108,62007,89,59580,1,1230,4,18,14,938,4,111,62,4392,48,1135,3.3,3262,1046448
585,2021/10/15 05:00:00+00,101,62108,76,59656,3,1233,2,17,13,940,14,106,61,4406,48,1158,3.2,3206,1049654
586,2021/10/16 05:00:00+00,73,62181,80,59736,2,1235,1,16,13,941,2,103,58,4408,45,1152,3.2,2443,1052097
587,2021/10/17 05:00:00+00,52,62233,81,59817,0,1235,0,16,12,941,11,106,60,4419,48,1121,3.3,2012,1054109
588,2021/10/18 05:00:00+00,111,62344,80,59897,0,1235,1,15,12,942,16,108,64,4435,52,1148,3.4,2242,1056351
589,2021/10/19 05:00:00+00,38,62382,49,59946,1,1236,1,15,13,943,7,103,60,4442,47,1140,3.4,2782,1059133
590,2021/10/20 05:00:00+00,88,62470,154,60100,0,1236,5,20,18,948,12,103,62,4454,44,1072,3.2,3645,1062778
591,2021/10/21 05:00:00+00,123,62593,97,60197,1,1237,1,21,19,949,10,101,64,4464,45,1095,3.3,2784,1065562
592,2021/10/22 05:00:00+00,99,62692,72,60269,1,1238,0,20,18,949,10,96,61,4474,43,1124,3.6,2794,1068356
593,2021/10/23 05:00:00+00,153,62845,93,60362,3,1241,3,21,18,952,12,96,61,4486,43,1181,3.8,2680,1071036
594,2021/10/24 05:00:00+00,68,62913,67,60429,2,1243,2,20,17,954,11,98,62,4497,45,1179,3.9,2137,1073173
595,2021/10/25 05:00:00+00,81,62994,76,60505,3,1246,1,17,14,955,13,95,60,4510,46,1183,4.5,2302,1075475
596,2021/10/26 05:00:00+00,116,63110,85,60590,0,1246,1,18,14,956,13,97,63,4523,49,1211,4.2,3194,1078669
597,2021/10/27 05:00:00+00,124,63234,83,60673,1,1247,5,23,18,961,8,100,62,4531,44,1252,3.9,3771,1082440
598,2021/10/28 05:00:00+00,135,63369,100,60773,0,1247,2,25,19,963,9,104,67,4540,48,1282,3.9,3025,1085465
599,2021/10/29 05:00:00+00,105,63474,74,60847,2,1249,1,26,19,964,12,109,69,4552,50,1309,4,2456,1087921
600,2021/10/30 05:00:00+00,122,63596,86,60933,1,1250,3,27,21,967,13,107,72,4565,51,1341,4,2434,1090355
601,2021/10/31 05:00:00+00,105,63701,105,61038,4,1254,0,25,19,967,9,114,78,4574,59,1331,4.6,1987,1092342
602,2021/11/01 05:00:00+00,119,63820,91,61129,0,1254,1,23,16,968,8,121,83,4582,67,1354,5,2331,1094673
603,2021/11/02 05:00:00+00,124,63944,99,61228,2,1256,2,21,15,970,9,121,79,4591,64,1381,5.1,2949,1097622
604,2021/11/03 05:00:00+00,149,64093,369,61597,4,1260,2,21,15,972,15,135,88,4606,73,1148,4.9,3976,1101598
605,2021/11/04 05:00:00+00,124,64217,129,61726,3,1263,4,24,17,976,8,133,88,4614,71,1140,4.8,3490,1105088
606,2021/11/05 05:00:00+00,178,64395,112,61838,3,1266,0,22,13,976,7,132,87,4621,74,1204,4.8,3125,1108213
607,2021/11/06 05:00:00+00,147,64542,103,61941,1,1267,1,23,13,977,8,148,103,4629,90,1231,5,2787,1111000
608,2021/11/07 05:00:00+00,180,64722,110,62051,0,1267,2,22,13,979,13,153,109,4642,96,1295,5.4,2568,1113568
609,2021/11/08 06:00:00+00,162,64884,129,62180,2,1269,5,26,18,984,9,152,107,4651,89,1328,6,2513,1116081
610,2021/11/09 06:00:00+00,139,65023,122,62302,1,1270,4,29,21,988,11,159,110,4662,89,1341,6.2,3087,1119168
611,2021/11/10 06:00:00+00,179,65202,224,62526,0,1270,1,29,21,989,8,163,109,4670,88,1297,6.1,3627,1122795
612,2021/11/11 06:00:00+00,167,65369,104,62630,3,1273,2,30,22,991,8,162,108,4678,86,1358,6.1,3497,1126292
613,2021/11/12 06:00:00+00,136,65505,134,62764,1,1274,1,29,21,992,10,161,107,4688,86,1360,5.9,1770,1128062
614,2021/11/13 06:00:00+00,105,65610,85,62849,5,1279,0,28,21,992,6,157,105,4694,84,1377,5.8,2261,1130323
615,2021/11/14 06:00:00+00,155,65765,157,63006,3,1282,2,27,19,994,12,165,110,4706,91,1367,6,2595,1132918
616,2021/11/15 06:00:00+00,114,65879,116,63122,3,1285,4,28,19,998,17,175,116,4723,97,1356,5.9,2244,1135162
617,2021/11/16 06:00:00+00,130,66009,133,63255,3,1288,2,28,20,1000,8,168,110,4731,90,1356,5.8,2908,1138070
618,2021/11/17 06:00:00+00,193,66202,249,63504,1,1289,3,30,21,1003,9,174,108,4740,87,1301,5.4,3721,1141791
619,2021/11/18 06:00:00+00,194,66396,159,63663,3,1292,2,30,19,1005,13,174,109,4753,90,1332,5.3,3493,1145284
620,2021/11/19 06:00:00+00,172,66568,153,63816,5,1297,2,29,19,1007,10,169,109,4763,90,1346,5.5,2728,1148012
621,2021/11/20 06:00:00+00,129,66697,135,63951,3,1300,1,29,18,1008,11,170,107,4774,89,1339,5.5,2463,1150475
622,2021/11/21 06:00:00+00,144,66841,115,64066,1,1301,2,28,18,1010,12,172,104,4786,86,1370,5.7,2561,1153036
623,2021/11/22 06:00:00+00,131,66972,117,64183,7,1308,3,30,19,1013,12,174,105,4798,86,1376,6,1769,1154805
624,2021/11/23 06:00:00+00,131,67103,107,64290,4,1312,2,28,19,1015,8,176,105,4806,86,1396,5.9,3029,1157834
625,2021/11/24 06:00:00+00,212,67315,233,64523,4,1316,2,28,17,1017,1,161,90,4807,73,1386,5.5,3892,1161726
626,2021/11/25 06:00:00+00,125,67440,113,64636,3,1319,3,29,18,1020,9,159,91,4816,73,1394,5.4,3123,1164849
627,2021/11/26 06:00:00+00,155,67595,137,64773,3,1322,2,27,16,1022,9,159,94,4825,78,1406,5.2,2888,1167737
628,2021/11/27 06:00:00+00,91,67686,99,64872,0,1322,2,27,17,1024,7,161,94,4832,77,1398,5.1,2133,1169870
629,2021/11/28 06:00:00+00,88,67774,73,64945,0,1322,1,26,17,1025,13,165,101,4845,84,1406,5.1,2187,1172057
630,2021/11/29 06:00:00+00,124,67898,185,65130,4,1326,4,28,18,1029,13,169,97,4858,79,1345,5.2,1877,1173934
631,2021/11/30 06:00:00+00,143,68041,172,65302,1,1327,3,28,16,1032,9,169,94,4867,78,1318,5.2,3126,1177060
632,2021/12/01 06:00:00+00,153,68194,214,65516,2,1329,2,29,17,1034,14,177,96,4881,79,1253,5.1,3368,1180428
633,2021/12/02 06:00:00+00,137,68331,109,65625,4,1333,0,27,17,1034,16,174,99,4897,82,1274,5.2,3138,1183566
634,2021/12/03 06:00:00+00,185,68516,142,65767,2,1335,1,25,17,1035,11,173,99,4908,82,1315,5.6,2657,1186223
635,2021/12/04 06:00:00+00,204,68720,124,65891,6,1341,2,25,17,1037,10,171,99,4918,82,1389,5.9,2628,1188851
636,2021/12/05 06:00:00+00,141,68861,91,65982,3,1344,2,26,18,1039,14,179,102,4932,84,1433,6.3,2205,1191056
637,2021/12/06 06:00:00+00,127,68988,134,66116,3,1347,6,30,21,1045,13,180,95,4945,74,1430,6.4,2523,1193579
638,2021/12/07 06:00:00+00,155,69143,123,66239,2,1349,4,31,22,1049,9,174,92,4954,70,1463,6.4,2877,1196456
639,2021/12/08 06:00:00+00,182,69325,225,66464,3,1352,3,31,24,1052,11,165,89,4965,65,1420,6.1,3628,1200084
640,2021/12/09 06:00:00+00,202,69527,137,66601,4,1356,4,35,26,1056,10,161,90,4975,64,1480,5.6,3522,1203606
641,2021/12/10 06:00:00+00,159,69686,150,66751,0,1356,1,34,25,1057,15,161,93,4990,68,1486,5.5,3081,1206687
642,2021/12/11 06:00:00+00,165,69851,160,66911,3,1359,2,34,26,1059,9,160,90,4999,64,1491,5.7,2427,1209114
643,2021/12/12 06:00:00+00,152,70003,151,67062,1,1360,2,36,28,1061,8,161,92,5007,64,1489,5.7,2519,1211633
644,2021/12/13 06:00:00+00,171,70174,135,67197,2,1362,0,36,28,1061,10,151,87,5017,59,1528,6,2787,1214420
645,2021/12/14 06:00:00+00,174,70348,139,67336,2,1364,1,36,26,1062,13,154,89,5030,63,1559,6.3,3359,1217779
646,2021/12/15 06:00:00+00,244,70592,267,67603,2,1366,1,36,24,1063,12,152,86,5042,62,1537,6.6,3791,1221570
647,2021/12/16 06:00:00+00,225,70817,161,67764,0,1366,0,33,23,1063,10,152,86,5052,63,1601,6.5,3782,1225352
648,2021/12/17 06:00:00+00,251,71068,95,67859,1,1367,3,35,24,1066,7,146,80,5059,56,1762,7.1,3397,1228749
649,2021/12/18 06:00:00+00,335,71403,101,67960,0,1367,2,34,25,1068,7,149,85,5066,60,1991,7.6,2992,1231741
650,2021/12/19 06:00:00+00,211,71614,86,68046,2,1369,0,29,22,1068,14,154,92,5080,70,2107,7.9,2444,1234185
651,2021/12/20 06:00:00+00,311,71925,84,68130,3,1372,1,28,21,1069,12,153,91,5092,70,2332,8.5,3515,1237700
652,2021/12/21 06:00:00+00,409,72334,60,68190,2,1374,2,27,20,1071,17,158,100,5109,80,2670,9.7,3580,1241280
653,2021/12/22 06:00:00+00,523,72857,215,68405,2,1376,2,27,19,1073,14,159,100,5123,81,2976,10.7,3983,1245263
654,2021/12/23 06:00:00+00,769,73626,50,68455,4,1380,5,26,18,1078,9,153,100,5132,82,3691,12.4,4703,1249966
655,2021/12/24 06:00:00+00,835,74461,34,68489,2,1382,2,27,18,1080,14,161,107,5146,89,4483,14.6,4105,1254071
656,2021/12/25 06:00:00+00,590,75051,16,68505,4,1386,3,26,19,1083,19,167,118,5165,99,5042,16.8,3485,1257556
657,2021/12/26 06:00:00+00,692,75743,22,68527,3,1389,3,27,21,1086,10,170,121,5175,100,5706,18.8,2553,1260109
658,2021/12/27 06:00:00+00,877,76620,9,68536,1,1390,1,27,21,1087,10,174,127,5185,106,6567,21.7,3272,1263381
659,2021/12/28 06:00:00+00,972,77592,10,68546,2,1392,2,26,21,1089,21,191,144,5206,123,7510,24,4011,1267392
660,2021/12/29 06:00:00+00,1232,78824,145,68691,3,1395,4,28,23,1093,19,197,150,5225,127,8588,27.1,3499,1270891
661,2021/12/30 06:00:00+00,1647,80471,33,68724,3,1398,4,31,27,1097,22,204,156,5247,129,10193,30.4,4473,1275364
662,2021/12/31 06:00:00+00,1770,82241,16,68740,3,1401,2,30,26,1099,19,211,166,5266,140,11934,32.5,5225,1280589
663,2022/01/01 06:00:00+00,1830,84071,16,68756,0,1401,1,29,26,1100,20,224,180,5286,154,13734,34.3,4904,1285493
664,2022/01/02 06:00:00+00,1556,85627,16,68772,1,1402,3,30,27,1103,22,233,190,5308,163,15263,37.6,4307,1289800
665,2022/01/03 06:00:00+00,2061,87688,16,68788,0,1402,3,29,27,1106,32,255,213,5340,186,17285,38.8,4612,1294412
666,2022/01/04 06:00:00+00,1362,89050,16,68804,0,1402,3,30,29,1109,19,252,211,5359,182,18633,40.3,4822,1299234
